WWWWWWWWWWWW
WWWWBW.V...W
WW.H.WV..B.W
W..BBB..UBBW
W..BB.B....W
WH....WBBWWW
WB.BB.WWWWWW
WWWWWWWWWWWW

#V - Vertical_monster
#H - Horizontal_monster
#P - Permanent_monster
#U - User
#B - Box
#W - Wall