WWWWWWWWWWWW
WWWWWWWW...W
WWWWW..W...W
WW.......H.W
W..U.......W
W..W...W.B.W
W.PWV.V....W
WWWWWWWWWWWW

#V - Vertical_monster
#H - Horizontal_monster
#P - Permanent_monster
#U - User
#B - Box
#W - Wall